%%%%%%%%%%%%%%%%%%%%%%%%%%%%%%%%%%%%%
%P                                  %
%                                   %
%                                   %
%                                   %
%                                   %
%                                   %
%                                   %
%                                   %
%                                   %
%                                   %
%                 G                 %
%%%%%%%%%%%%%%%%%%%%%%%%%%%%%%%%%%%%%
