%%%%%%%%%%%%%%%%%%%%%%%%%%%%%%%%%%%%%
%                    P%             %
%                     %             %
%                     %             %
%                     %             %
%                     %             %
%       %%%%%%%%%%%%%%%    %        %
%                          %        %
%                          %        %
%                          %        %
%                          %        %
%                          %        %
%    %%%%%%%%%%%%%%%%%%%%%%%        %
%        %                          %
%        %                          %
%        %                          %
%        %                          %
%        %                          %
%        %G                         %
%%%%%%%%%%%%%%%%%%%%%%%%%%%%%%%%%%%%%