%%%%%%%%%%%%
%P         %
%       G  %
%          %
%          %
%          %
%          %
%          %
%          %
%          %
%          %
%%%%%%%%%%%%
