%%%%%%%%%%%%%%%%%%%%%%%%%%%%%%%%%%%%%%%%%%%%%%%%%%%%%%%%%%%%%%%%%%%%%%%%%%%%%%%%%%%%%%%%%%%%%%%%%%%%%%%%%%%%%%%%%%%%%%%%%%%
% P                                                                                                                       %
%                                                                                                                         %
%                                                                                                                         %
%                                                                                                                         %
%                                                                                                                         %
%                                                                                                                         %
%                                                                                                                         %
%                                                                                                                         %
%                                                                                                                         %
%                                                                                                                         %
%                                                                                                                         %
%                                                                                                                         %
%                                                                                                                         %
%                                                                                                                         %
%                                                                                                                         %
%                                                                                                                         %
%                                                                                                                         %
%                                                                                                                         %
%                                                                                                                         %
%                                                                                                                         %
%                                                                                                                         %
%                                                                                                                         %
%                                                                                                                         %
%                                                                                                                         %
%                                                                                                                         %
%                                                                                                                         %
%                                                                                                                         %
%                                                                                                                         %
%                                                                                                                         %
%                                                                                                                         %
%                                                                                                                         %
%                                                                                                                         %
%                                                                                                                         %
%                                                                                                                         %
%                                                                                                                         %
%                                                                                                                         %
%                                                                                                                         %
%                                                                                                                         %
%                                                                                                                         %
%                                                                                                                         %
%                                                                                                                         %
%                                                                                                                         %
%                                                                                                                         %
%                                                                                                                         %
%                                                                                                                         %
%                                                                                                                         %
%                                                                                                                         %
%                                                                                                                         %
%                                                                                                                         %
%                                                                                                                         %
%                                                                                                                         %
%                                                                                                                         %
%                                                                                                                         %
%                                                                                                                         %
%                                                                                                                         %
%                                                                                                                         %
%                                                                                                                         %
%                                                                                                                         %
%                                                                                                                         %
%                                                                                                           G             %
%                                                                                                                         %
%                                                                                                                         %
%                                                                                                                         %
%                                                                                                                         %
%                                                                                                                         %
%%%%%%%%%%%%%%%%%%%%%%%%%%%%%%%%%%%%%%%%%%%%%%%%%%%%%%%%%%%%%%%%%%%%%%%%%%%%%%%%%%%%%%%%%%%%%%%%%%%%%%%%%%%%%%%%%%%%%%%%%%%
