%%%%%%%%%%%%
%P         %
%          %
%          %
%          %
%          %
%          %
%          %
%          %
%          %
%         G%
%%%%%%%%%%%%
