%%%%%%%%%%%%%%%%%%%%%%%%%%%%%%%%%%%%%%%%%%%%%%%%%%%%%%%%%%%%%%%%%%%%%%%%%%%%%%%%%%%%%%%%%%%%%%%%%%%%%%%%%%%%%%%%%%%%%%%%%%%
%%%%%%%P%%%%%%%%%   %%%%%%%%%%%%%%%%%%%%%% %%%       %%%%%%%    % %%%%%%%%%%%%%%                                   G      %
%%%%%%% %%%%%%    % %%%%%%% %%%%           %%% %%%%% %%%%%%% %% %         %%%%%%                                 %%%%%%%% %
%%%%%%       % %%%% %%%%%%% %%%%%%%%%%%%%% %%% %%%%% %%%%%%% %% %%%%%%%%% %%%%%%%%%%%%%%%%%%%% %%     % %%% %%%% %%%    % %
%%%    %%%%%   %%%% % %%%%% %%%%%%%%%%%%%% %%% %%%%% %%%%%%% %% %%%%%%%%% %%%%%% %%          % %% % % % %%% %%%% %%% %% % %
%%% %% %%%%% %%%%%%   %%%%% %%%%%%%%%%%%%% %%% %%%%% %%%%%%%%%%                  %% %%%%%%%% % %% % % % %   %%%% %%% %% % %
%   %% %%%%% %%%   %%%%%%%% %%%%%%%%%%%%%% %%% %%%%% %%%%%   %%%%%%%%%%%%%%%%%%% %% %%%%%%%% %  % % % %   %%%%%%%%%% %% % %
% %%%% %%%%  %%% %             %%%%%%%%%%% %%% %%%%% %%%%% % %%%%%%%%%%%%%%%%%%  %%     %%%% %% % %%%  %%%%%%%%%     %% % %
%    %       %%% %% %%%%%%%%%%%%%%%%%%%%%% %%% %%    %%%%% %         %%%%%%%%%%%        %%%% %  %   %% %%%%%%%%% %%%%%% % %
%%%% % %%%%% %%% %% %%%%%%%%%%%%%%%%%%%%%% %%  %% %%%%%%%% %%%%%%%%% %%%%%%%%%%% %%%%%  %%%%        %% %%%%%%%%% %%%%%% % %
% %  %%%%%%% %%% %% %%%%%%%%%%%%%%%%%%%%%% % %%%%          %%%%%%%%%    %%%%%%%% %%%%% %%%%%%% %%%  %% %%%%%%%%% %%%    % %
% % %%%%%%%%     %% %%%%%%%%%%%%%%%%%%%%%% % %%%%%%%%%%%%%%%%%%%%%%%%%% %%%%%%%% %%%%% %%%%%%% %%% %%%    %%     %%% %%%% %
% %        %%%%%%%%                  %%%%% % %%%%                          %%%%%       %%%%%%% %%% %%%%%% %% %%%%%%% %%%% %
%  %%%%%%% %%%%%%%% %%%%%%%%%%%%%%%%% %%%% % %%%%% %%%%%%%%%%%%%%%%%%%%%%%%%%%%% %%%%%%%%%%%   %%  %%%%%% %% %%%%%%% %%%% %
%%  %      %%%%%    %%%%%%%%%%%%%%%%% %%%% % %%%%% %%%%%%%%%%%%%%%%%%%%%%%%%%%%% %%%%%%%%%%% %%%% %%%%%%%    %%%%%%%      %
%%% %%% %% %%%%% %%%%%%%%%%%%%%%%%%%  %%%%%%%%%%%% %%%%%%%%%%%%%%%%%%%%%%%%%%%%% %%%%%%%%%%%   %% %%%%%%% %%%%%%%%%%%%%%%%%
%%% %%% %  %%%%% %                                           %%%%%%%%%%%%%%%%%%%   %%%%%%%%%%% %%  %%%%%% %%%%%%%%%%%%%%%%%
%%% %%%   %%%%%%  %%%%%%%%%%%%%%%%%%%%%%%%%%%%%%%%%%%%%%%%%% %%%%%%%%%%%%%%%%%%% % %%%%%%%     %%% %%%%%% %%%%%%%%%%%%%%%%%
%%  %%%%% %%%%%%% %%%%%%%%%%%%%%%%%%%%%%%%%%%%%%%%%%%%%%%%%% %%%%%%%%%%%%%%%%%%% % %%%%%%% %%%%%%  %%%%%% %%%%%%%%%%%%%%%%%
%% %%     %% %%                                                               %% % %%%%%%%      % %%%%%%%%%%%%%%%%%%%%%%%%%
%% %  %%%%%% %   %%%%%%%%%%%%%%%%%%%%%%%%%%%%%%%%%%%%%%%%%%%%%%%%%%%%%%%%%%%%%%% % %%%%%%%%%%%% % %%%%%%%%%%%%%%%%%%%%%%%%%
%% % %%%%%%% % %%%%%%%%%%%%%%%%%%%%%%%%%%%%%%%%%%%%%%%%%%%%%%%%%%%%%%%%%%%%%%%%% % %   %%%%%%%%   %%%%%%%%%%%%%%%%%%%%%%%%%
%% % %%      % %%%%%%%%%%%%%%%%%%%%%%%%%%%%%%%%%%%%%%%%%%%%%%%%%%%%%%%%%%%%%%%%% % % % %%%%%%%%%%%%%%%%%%%%%%%%%%%%%%%%%%%%
%% % %% %%%%%% %%%%%%%%%%%%%%%%%%%%%%%%%%%%%%%%%%%%%%%%%%%%%%%%%%%%%%%%%%%%%%%%% %   % %%%%%%%%%%%%%%%%%%%%%%%%%%%%%%%%%%%%
%%   %% %%%%%% %%%%%%%%%%%%%%%%%%%%%%%%%%%%%%%%%%%%%%%%%%%%%%%%%%%%%%%%%%%%%%%%% %%% % %%%%%%%%%%%%%%%%%%%%%%%%%%%%%%%%%%%%
%%%%  % %%%%%% %%%%%%%%%%%%%%%%%%%%%                                             %%%%%  %%%%%%%%%%%%%%%%%%%%%%%%%%%%%%%%%%%
%%%% %%   %%%%       %%%%%%%%%%%%%%% %%%%%%%%%%%%%%%%%%%%%%%%%%%%%%%%%%%%%%%%%%%%%%%%%% %%%%%%%%%%%%%%%%%%%%%%%%%%%%%%%%%%%
%%%%%%%%% %%%% %%%%% %%%%%%%%%%%%%%% %%%%%%%%%%            %%%%%%%%%%%%%%%%   %%%%%%%   %%%%%%%%%%%%%%%%%%%%%%%%%%%%%%%%%%%
%%%%%%%%% %%%% %%%%%               % %%%%%%%%%%            %%%%%%%%%%%%%%%% %  %%%%%% %%%%%%%%%%%%%%%%%%%%%%%%%%%%%%%%%%%%%
%%%%%   % %%%% %%%%%%%%%%%%%%%%%%% % %%%%%%%%%%            %%%%%%%%%%%%%%%% %% %%%%%% %% %%%%%%%%%%%%%%%%%%%%%%%%%%%%%%%%%%
%%%%% % % %%%% %%%%%%%%%%%%%%%%%%% % %%%%%%%%%%%           %%%%%%%%%%%%%%%% %%        %% %%%%%%%%%%%%%%%%%%%%%%%%%%%%%%%%%%
%%%%% %   %%%% %%%%%%%%%%%%%%%%%%% % %%%%%%%%%%%%%%%%% %%%%%%%%%%%%%%%%%%%% %%%%%%%%%%%% %%%%%%%%%%%%%%%%%%%%%%%%%%%%%%%%%%
%%%%% %%%%%%%% %%%%%%%%%%%%%%%%%%% % %%%%%%%%%%%%%%%%%                      %%%%%%%%%%%% %%%%%%%%%%%%%%%%%%%%%%%%%%%%%%%%%%
%%%%%          %%%%%%%%%%%%%%%%%%% % %%%%%%%%%%%%%%%%%%%%%%%%%%%%%%%%%%%%%%%%%%%%%%%%%%% %%%%%%%%%%%%%%%%%%%%%%%%%%%%%%%%%%
%%%%%%%%%%%%%% %%%%%%%%%%%%%%%%%%% % %%%%%%%%%%%%%%%%%%%%%%%%%%%%%%%%%%%%%%%%%%%%%%%%%%% %%%%%%%%%%%%%%%%%%%%%%%%%%%%%%%%%%
%%%%%% %%%%%%% %%%%%%%%%%%%%%%%%%% % %%%%%%%%%%%%%%%%%%%%%%%%%%%%%%%%%%%%%%%%%%%%%%%%%%% %%%%%%%%%%%%%%%%%%%%%%%%%%%%%%%%%%
%%%%%% %%%%%%% %%%%%%%%%%%%%%%%%%% % %%%%%          %%%%%%%%%%%%%%%%%%%%%%%%%%%%%%%%%%%% %%%%%%%%%%%%%%%%%%%%%%%%%%%%%%%%%%
%%%%%% %%%%%%% %%%%%%%%%%%%%%%%%%%%% %     %%%%%%%% %%%%%%%%%%%%%%%%%%%%%%%%%%%%%%%%%%%% %%%%%%%%%%%%%%%%%%%%%%%%%%%%%%%%%%
%%%%%% %%%%%%% %                     % %%%%%%%%%%%% %%%%%%%%%%%%%%%%%%%%%%%%%%%%         %%%%%%%%%%%%%%%%%%%%%%%%%%%%%%%%%%
%%%%%% %%%%%%% % %%%%%%%%%%%%%%%%%%%%% %%%%%%%%%%%% %%%%%%%%%%%%%%%%%%%%%%%%%%%% %%%%%%% %%%%%%%%%%%%%%%%%%%%%%%%%%%%%%%%%%
%%%%%% %%%%%%% % %%%%%%%%%%%%%%%%%%%%% %%%%%%%%%%%% %%%%%%%%%%%%%%%%%%%%%%%%%%%% %%%%%%% %%%%%%%%%%%%%%%%%%%%%%%%%%%%%%%%%%
%%%%%% %%%%%%% %                       %%%%%%%%%%%% %%%%%%%%%%%%%%%%%%%%%%%%%%%% %%%%%%% %%%%%%%%%%%%%%%%%%%%%%%%%%%%%%%%%%
%%%%%% %%%%%%% %%%%%%%%%%%%%%%%%%%%%%%%%%%%%%%%%%%% %%%%%%%%%%%%%%%%%%%%%%%%%%%% %%%%%%% %%%%%%%%%%%%%%%%%%%%%%%%%%%%%%%%%%
%%%%%          %%%%%%%%%%%%%%%% %%%%%%%%%%%%%%%%%%% %%%%%%%%%%%%%%%%%%%%%%%%%%%% %%%%%%% %%%%%%%%%%%%%%%%%%%%%%%%%%%%%%%%%%
%%%%%%%%%%%%%% %%%%%%%%%%%%%%%% %%%%%%%%%%%%%%%%%%% %%%%%%%%%%%%%%%%%%%%%%%%%%%% %%%%%%% %%%%%%%%%%%%%%%%%%%%%%%%%%%%%%%%%%
%%%%%%%%%%%%%%       %%%%%%%%%% %%%%%%%%%%%%%%%%%%% %%%%%%%%%%%%%%%%%%%%%%%%%%%% %%%%%%% %%%%%%%%%%%%%%%%%%%%%%%%%%%%%%%%%%
%%%%%%%%%%%%%%%%%%%% %%%%%%%%%% %%%%%%%%%%%%%%%%%%% %%%%%%%%%%%%%%%%%%%%%%%%%%%% %%%%%%% %%%%%%%%%%%%%%%%%%%%%%%%%%%%%%%%%%
%%%%%%%%%%%%%%%%%%%% %%%%%%%%%% %%%%%%%%%%%%%%%%%%% %%%%%%%%%%%%%%%%%%%%%%%%%%%% %%%%%%% %%%%%%%%%%%%%%%%%%%%%%%%%%%%%%%%%%
%%%%%%%%%%%%%%%%%%%% %%%%%%%%%% %%%%%%%%%%%%%%%%%%% %%%%%%%%%%%%%%%%%%%%%%%%%%%% %%%%%%% %%%%%%%%%%%%%%%%%%%%%%%%%%%%%%%%%%
%%%%%%%%%%%%%%%%%%%% %%%%%%%%%% %%%%%%%%%%%%%%%%%%% %%%%%%%%%%%%%%%%%%%%%%%%%%%% %%%%%%% %%%%%%%%%%%%%%%%%%%%%%%%%%%%%%%%%%
%%%%%%%%%%%%%%%%%%%% %%%%%%%%%% %%%%%%%%%%%%%%%%%%% %%%%%%%%%%%%%%%%%%%%%%%%%%%%%%%%%%%% %%%%%%%%%%%%%%%%%%%%%%%%%%%%%%%%%%
%%%%%%%%%%%%%%%%%%%% %%%%%%%%%% %%%%%%%%%%%%%%%%%%%                                      %%%%%%%%%%%%%%%%%%%%%%%%%%%%%%%%%%
%%%%%%%%%%%%%%%%%%%% %%%%%%%%%% %%%%%%%%%%%%%%%%%%% %%%%%%%%%%%%%%%%%%%%%%%%%%%%%%%%%%%%%%%%%%%%%%%%%%%%%%%%%%%%%%%%%%%%%%%
%%%%%%%%%%%%%%%%%%%% %%%%%%%%%% %%%%%%%%%%%%%%%%%%% %%%%%%%%%%%%%%%%%%%%%%%%%%%%%%%%%%%%%%%%%%%%%%%%%%%%%%%%%%%%%%%%%%%%%%%
%%%%%%%%%%%%%%%%%%%% %%%%%%%%%% %%%%%%%%%%%%%%%%%%% %%%%%%%%%%%%%%%%%%%%%%%%%%%%%%%%%%%%%%%%%%%%%%%%%%%%%%%%%%%%%%%%%%%%%%%
%%%%%%%%%%%%%%%%%%%%                                %%%%%%%%%%%%%%%%%%%%%%%%%%%%%%%%%%%%%%%%%%%%%%%%%%%%%%%%%%%%%%%%%%%%%%%
%%%%%%%%%%%%%%%%%%%%%%%%%%%%%%%%%%%%%%%%%%%%%%%%%%%%%%%%%%%%%%%%%%%%%%%%%%%%%%%%%%%%%%%%%%%%%%%%%%%%%%%%%%%%%%%%%%%%%%%%%%%
%%%%%%%%%%%%%%%%%%%%%%%%%%%%%%%%%%%%%%%%%%%%%%%%%%%%%%%%%%%%%%%%%%%%%%%%%%%%%%%%%%%%%%%%%%%%%%%%%%%%%%%%%%%%%%%%%%%%%%%%%%%
%%%%%%%%%%%%%%%%%%%%%%%%%%%%%%%%%%%%%%%%%%%%%%%%%%%%%%%%%%%%%%%%%%%%%%%%%%%%%%%%%%%%%%%%%%%%%%%%%%%%%%%%%%%%%%%%%%%%%%%%%%%
%%%%%%%%%%%%%%%%%%%%%%%%%%%%%%%%%%%%%%%%%%%%%%%%%%%%%%%%%%%%%%%%%%%%%%%%%%%%%%%%%%%%%%%%%%%%%%%%%%%%%%%%%%%%%%%%%%%%%%%%%%%
%%%%%%%%%%%%%%%%%%%%%%%%%%%%%%%%%%%%%%%%%%%%%%%%%%%%%%%%%%%%%%%%%%%%%%%%%%%%%%%%%%%%%%%%%%%%%%%%%%%%%%%%%%%%%%%%%%%%%%%%%%%
%%%%%%%%%%%%%%%%%%%%%%%%%%%%%%%%%%%%%%%%%%%%%%%%%%%%%%%%%%%%%%%%%%%%%%%%%%%%%%%%%%%%%%%%%%%%%%%%%%%%%%%%%%%%%%%%%%%%%%%%%%%
%%%%%%%%%%%%%%%%%%%%%%%%%%%%%%%%%%%%%%%%%%%%%%%%%%%%%%%%%%%%%%%%%%%%%%%%%%%%%%%%%%%%%%%%%%%%%%%%%%%%%%%%%%%%%%%%%%%%%%%%%%%
