%%%%%%%%%%%%%%%%%%%%%%%%%%%%%%%%%%%%%%%%%%%%%%%%%%%%%%%%%%%%%%%%%%%%%%%%%%%%%%%%%%%%%%%%%%%%%%%%%%%%%%%%%%%%%%%%%%%%%%%%%%%
%%%%%%%P%%%%%%%%%   %%%%%%%%%%%%%%%%%%%%%% %%%       %%%%%%%    % %%%%%%%%%%%%%%                                   G%%%%%%%
%%%%%%% %%%%%%    % %%%%%%% %%%%           %%% %%%%% %%%%%%% %% %         %%%%%% %%%%%%%%%%%%% %%%%%%%%%%%%%%%%%%%%%%%%%%%%
%%%%%%       % %%%% %%%%%%% %%%%%%%%%%%%%% %%% %%%%% %%%%%%% %% %%%%%%%%% %%%%%%%%%%%%%%%%%%%% %%%%%%%%%%%%%%%%%%%%%%%%%%%%
%%%    %%%%%   %%%% % %%%%% %%%%%%%%%%%%%% %%% %%%%% %%%%%%% %% %%%%%%%%% %%%%%% %%          % %%%%%%%%%%%%%%%%%%%%%%%%%%%%
%%% %% %%%%% %%%%%%   %%%%% %%%%%%%%%%%%%% %%% %%%%% %%%%%%%%%%                  %% %%%%%%%% % %%%%%%%%%%%%%%%%%%%%%%%%%%%%
%   %% %%%%% %%%   %%%%%%%% %%%%%%%%%%%%%% %%% %%%%% %%%%%   %%%%%%%%%%%%%%%%%%% %% %%%%%%%% %  %%%%%%%%%%%%%%%%%%%%%%%%%%%
% %%%% %%%%  %%% %             %%%%%%%%%%% %%% %%%%% %%%%% % %%%%%%%%%%%%%%%%%%  %%     %%%% %% %%%%%%%%%%%%%%%%%%%%%%%%%%%
%    %       %%% %% %%%%%%%%%%%%%%%%%%%%%% %%% %%    %%%%% %         %%%%%%%%%%%   %%%% %%%% %  %%%%%%%%%%%%%%%%%%%%%%%%%%%
%%%% % %%%%% %%% %% %%%%%%%%%%%%%%%%%%%%%% %%  %% %%%%%%%% %%%%%%%%% %%%%%%%%%%% %%%%%  %%%%   %%%%%%%%%%%%%%%%%%%%%%%%%%%%
% %  %%%%%%% %%% %% %%%%%%%%%%%%%%%%%%%%%% % %%%%          %%%%%%%%%    %%%%%%%% %%%%% %%%%%%%%%%%%%%%%%%%%%%%%%%%%%%%%%%%%
% % %%%%%%%%     %% %%%%%%%%%%%%%%%%%%%%%% % %%%%%%%%%%%%%%%%%%%%%%%%%% %%%%%%%% %%%%% %%%%%%%%%%%%%%%%%%%%%%%%%%%%%%%%%%%%
% %        %%%%%%%%                  %%%%% % %%%%                          %%%%%       %%%%%%%%%%%%%%%%%%%%%%%%%%%%%%%%%%%%
%  %%%%%%% %%%%%%%% %%%%%%%%%%%%%%%%% %%%% % %%%%% %%%%%%%%%%%%%%%%%%%%%%%%%%%%% %%%%%%%%%%%%%%%%%%%%%%%%%%%%%%%%%%%%%%%%%%
%%  %      %%%%%    %%%%%%%%%%%%%%%%% %%%% % %%%%% %%%%%%%%%%%%%%%%%%%%%%%%%%%%% %%%%%%%%%%%%%%%%%%%%%%%%%%%%%%%%%%%%%%%%%%
%%% %%% %% %%%%% %%%%%%%%%%%%%%%%%%%  %%%%%%%%%%%% %%%%%%%%%%%%%%%%%%%%%%%%%%%%% %%%%%%%%%%%%%%%%%%%%%%%%%%%%%%%%%%%%%%%%%%
%%% %%% %  %%%%% %                                           %%%%%%%%%%%%%%%%%%%   %%%%%%%%%%%%%%%%%%%%%%%%%%%%%%%%%%%%%%%%
%%% %%%   %%%%%%  %%%%%%%%%%%%%%%%%%%%%%%%%%%%%%%%%%%%%%%%%% %%%%%%%%%%%%%%%%%%% % %%%%%%%%%%%%%%%%%%%%%%%%%%%%%%%%%%%%%%%%
%%  %%%%% %%%%%%% %%%%%%%%%%%%%%%%%%%%%%%%%%%%%%%%%%%%%%%%%% %%%%%%%%%%%%%%%%%%% % %%%%%%%%%%%%%%%%%%%%%%%%%%%%%%%%%%%%%%%%
%% %%     %% %%                                                               %% % %%%%%%%%%%%%%%%%%%%%%%%%%%%%%%%%%%%%%%%%
%% %  %%%%%% %   %%%%%%%%%%%%%%%%%%%%%%%%%%%%%%%%%%%%%%%%%%%%%%%%%%%%%%%%%%%%%%% % %%%%%%%%%%%%%%%%%%%%%%%%%%%%%%%%%%%%%%%%
%% % %%%%%%% % %%%%%%%%%%%%%%%%%%%%%%%%%%%%%%%%%%%%%%%%%%%%%%%%%%%%%%%%%%%%%%%%% % %   %%%%%%%%%%%%%%%%%%%%%%%%%%%%%%%%%%%%
%% % %%      % %%%%%%%%%%%%%%%%%%%%%%%%%%%%%%%%%%%%%%%%%%%%%%%%%%%%%%%%%%%%%%%%% % % % %%%%%%%%%%%%%%%%%%%%%%%%%%%%%%%%%%%%
%% % %% %%%%%% %%%%%%%%%%%%%%%%%%%%%%%%%%%%%%%%%%%%%%%%%%%%%%%%%%%%%%%%%%%%%%%%% %   % %%%%%%%%%%%%%%%%%%%%%%%%%%%%%%%%%%%%
%%   %% %%%%%% %%%%%%%%%%%%%%%%%%%%%%%%%%%%%%%%%%%%%%%%%%%%%%%%%%%%%%%%%%%%%%%%% %%% % %%%%%%%%%%%%%%%%%%%%%%%%%%%%%%%%%%%%
%%%%  % %%%%%% %%%%%%%%%%%%%%%%%%%%%                                             %%%%%  %%%%%%%%%%%%%%%%%%%%%%%%%%%%%%%%%%%
%%%% %%   %%%%       %%%%%%%%%%%%%%% %%%%%%%%%%%%%%%%%%%%%%%%%%%%%%%%%%%%%%%%%%%%%%%%%% %%%%%%%%%%%%%%%%%%%%%%%%%%%%%%%%%%%
%%%%%%%%% %%%% %%%%% %%%%%%%%%%%%%%% %%%%%%%%%%            %%%%%%%%%%%%%%%%   %%%%%%%   %%%%%%%%%%%%%%%%%%%%%%%%%%%%%%%%%%%
%%%%%%%%% %%%% %%%%%               % %%%%%%%%%%            %%%%%%%%%%%%%%%% %  %%%%%% %%%%%%%%%%%%%%%%%%%%%%%%%%%%%%%%%%%%%
%%%%%   % %%%% %%%%%%%%%%%%%%%%%%% % %%%%%%%%%%            %%%%%%%%%%%%%%%% %% %%%%%% %% %%%%%%%%%%%%%%%%%%%%%%%%%%%%%%%%%%
%%%%% % % %%%% %%%%%%%%%%%%%%%%%%% % %%%%%%%%%%%           %%%%%%%%%%%%%%%% %%        %% %%%%%%%%%%%%%%%%%%%%%%%%%%%%%%%%%%
%%%%% %   %%%% %%%%%%%%%%%%%%%%%%% % %%%%%%%%%%%%%%%%% %%%%%%%%%%%%%%%%%%%% %%%%%%%%%%%% %%%%%%%%%%%%%%%%%%%%%%%%%%%%%%%%%%
%%%%% %%%%%%%% %%%%%%%%%%%%%%%%%%% % %%%%%%%%%%%%%%%%%                      %%%%%%%%%%%% %%%%%%%%%%%%%%%%%%%%%%%%%%%%%%%%%%
%%%%%          %%%%%%%%%%%%%%%%%%% % %%%%%%%%%%%%%%%%%%%%%%%%%%%%%%%%%%%%%%%%%%%%%%%%%%% %%%%%%%%%%%%%%%%%%%%%%%%%%%%%%%%%%
%%%%%%%%%%%%%% %%%%%%%%%%%%%%%%%%% % %%%%%%%%%%%%%%%%%%%%%%%%%%%%%%%%%%%%%%%%%%%%%%%%%%% %%%%%%%%%%%%%%%%%%%%%%%%%%%%%%%%%%
%%%%%% %%%%%%% %%%%%%%%%%%%%%%%%%% % %%%%%%%%%%%%%%%%%%%%%%%%%%%%%%%%%%%%%%%%%%%%%%%%%%% %%%%%%%%%%%%%%%%%%%%%%%%%%%%%%%%%%
%%%%%% %%%%%%% %%%%%%%%%%%%%%%%%%% % %%%%%          %%%%%%%%%%%%%%%%%%%%%%%%%%%%%%%%%%%% %%%%%%%%%%%%%%%%%%%%%%%%%%%%%%%%%%
%%%%%% %%%%%%% %%%%%%%%%%%%%%%%%%%%% %     %%%%%%%% %%%%%%%%%%%%%%%%%%%%%%%%%%%%%%%%%%%% %%%%%%%%%%%%%%%%%%%%%%%%%%%%%%%%%%
%%%%%% %%%%%%% %                     % %%%%%%%%%%%% %%%%%%%%%%%%%%%%%%%%%%%%%%%%         %%%%%%%%%%%%%%%%%%%%%%%%%%%%%%%%%%
%%%%%% %%%%%%% % %%%%%%%%%%%%%%%%%%%%% %%%%%%%%%%%% %%%%%%%%%%%%%%%%%%%%%%%%%%%% %%%%%%% %%%%%%%%%%%%%%%%%%%%%%%%%%%%%%%%%%
%%%%%% %%%%%%% % %%%%%%%%%%%%%%%%%%%%% %%%%%%%%%%%% %%%%%%%%%%%%%%%%%%%%%%%%%%%% %%%%%%% %%%%%%%%%%%%%%%%%%%%%%%%%%%%%%%%%%
%%%%%% %%%%%%% %                       %%%%%%%%%%%% %%%%%%%%%%%%%%%%%%%%%%%%%%%% %%%%%%% %%%%%%%%%%%%%%%%%%%%%%%%%%%%%%%%%%
%%%%%% %%%%%%% %%%%%%%%%%%%%%%%%%%%%%%%%%%%%%%%%%%% %%%%%%%%%%%%%%%%%%%%%%%%%%%% %%%%%%% %%%%%%%%%%%%%%%%%%%%%%%%%%%%%%%%%%
%%%%%          %%%%%%%%%%%%%%%% %%%%%%%%%%%%%%%%%%% %%%%%%%%%%%%%%%%%%%%%%%%%%%% %%%%%%% %%%%%%%%%%%%%%%%%%%%%%%%%%%%%%%%%%
%%%%%%%%%%%%%% %%%%%%%%%%%%%%%% %%%%%%%%%%%%%%%%%%% %%%%%%%%%%%%%%%%%%%%%%%%%%%% %%%%%%% %%%%%%%%%%%%%%%%%%%%%%%%%%%%%%%%%%
%%%%%%%%%%%%%%       %%%%%%%%%% %%%%%%%%%%%%%%%%%%% %%%%%%%%%%%%%%%%%%%%%%%%%%%% %%%%%%% %%%%%%%%%%%%%%%%%%%%%%%%%%%%%%%%%%
%%%%%%%%%%%%%%%%%%%% %%%%%%%%%% %%%%%%%%%%%%%%%%%%% %%%%%%%%%%%%%%%%%%%%%%%%%%%% %%%%%%% %%%%%%%%%%%%%%%%%%%%%%%%%%%%%%%%%%
%%%%%%%%%%%%%%%%%%%% %%%%%%%%%% %%%%%%%%%%%%%%%%%%% %%%%%%%%%%%%%%%%%%%%%%%%%%%% %%%%%%% %%%%%%%%%%%%%%%%%%%%%%%%%%%%%%%%%%
%%%%%%%%%%%%%%%%%%%% %%%%%%%%%% %%%%%%%%%%%%%%%%%%% %%%%%%%%%%%%%%%%%%%%%%%%%%%% %%%%%%% %%%%%%%%%%%%%%%%%%%%%%%%%%%%%%%%%%
%%%%%%%%%%%%%%%%%%%% %%%%%%%%%% %%%%%%%%%%%%%%%%%%% %%%%%%%%%%%%%%%%%%%%%%%%%%%% %%%%%%% %%%%%%%%%%%%%%%%%%%%%%%%%%%%%%%%%%
%%%%%%%%%%%%%%%%%%%% %%%%%%%%%% %%%%%%%%%%%%%%%%%%% %%%%%%%%%%%%%%%%%%%%%%%%%%%%%%%%%%%% %%%%%%%%%%%%%%%%%%%%%%%%%%%%%%%%%%
%%%%%%%%%%%%%%%%%%%% %%%%%%%%%% %%%%%%%%%%%%%%%%%%%                                      %%%%%%%%%%%%%%%%%%%%%%%%%%%%%%%%%%
%%%%%%%%%%%%%%%%%%%% %%%%%%%%%% %%%%%%%%%%%%%%%%%%% %%%%%%%%%%%%%%%%%%%%%%%%%%%%%%%%%%%%%%%%%%%%%%%%%%%%%%%%%%%%%%%%%%%%%%%
%%%%%%%%%%%%%%%%%%%% %%%%%%%%%% %%%%%%%%%%%%%%%%%%% %%%%%%%%%%%%%%%%%%%%%%%%%%%%%%%%%%%%%%%%%%%%%%%%%%%%%%%%%%%%%%%%%%%%%%%
%%%%%%%%%%%%%%%%%%%% %%%%%%%%%% %%%%%%%%%%%%%%%%%%% %%%%%%%%%%%%%%%%%%%%%%%%%%%%%%%%%%%%%%%%%%%%%%%%%%%%%%%%%%%%%%%%%%%%%%%
%%%%%%%%%%%%%%%%%%%%                                %%%%%%%%%%%%%%%%%%%%%%%%%%%%%%%%%%%%%%%%%%%%%%%%%%%%%%%%%%%%%%%%%%%%%%%
%%%%%%%%%%%%%%%%%%%%%%%%%%%%%%%%%%%%%%%%%%%%%%%%%%%%%%%%%%%%%%%%%%%%%%%%%%%%%%%%%%%%%%%%%%%%%%%%%%%%%%%%%%%%%%%%%%%%%%%%%%%
%%%%%%%%%%%%%%%%%%%%%%%%%%%%%%%%%%%%%%%%%%%%%%%%%%%%%%%%%%%%%%%%%%%%%%%%%%%%%%%%%%%%%%%%%%%%%%%%%%%%%%%%%%%%%%%%%%%%%%%%%%%
%%%%%%%%%%%%%%%%%%%%%%%%%%%%%%%%%%%%%%%%%%%%%%%%%%%%%%%%%%%%%%%%%%%%%%%%%%%%%%%%%%%%%%%%%%%%%%%%%%%%%%%%%%%%%%%%%%%%%%%%%%%
%%%%%%%%%%%%%%%%%%%%%%%%%%%%%%%%%%%%%%%%%%%%%%%%%%%%%%%%%%%%%%%%%%%%%%%%%%%%%%%%%%%%%%%%%%%%%%%%%%%%%%%%%%%%%%%%%%%%%%%%%%%
%%%%%%%%%%%%%%%%%%%%%%%%%%%%%%%%%%%%%%%%%%%%%%%%%%%%%%%%%%%%%%%%%%%%%%%%%%%%%%%%%%%%%%%%%%%%%%%%%%%%%%%%%%%%%%%%%%%%%%%%%%%
%%%%%%%%%%%%%%%%%%%%%%%%%%%%%%%%%%%%%%%%%%%%%%%%%%%%%%%%%%%%%%%%%%%%%%%%%%%%%%%%%%%%%%%%%%%%%%%%%%%%%%%%%%%%%%%%%%%%%%%%%%%
%%%%%%%%%%%%%%%%%%%%%%%%%%%%%%%%%%%%%%%%%%%%%%%%%%%%%%%%%%%%%%%%%%%%%%%%%%%%%%%%%%%%%%%%%%%%%%%%%%%%%%%%%%%%%%%%%%%%%%%%%%%
