%%%%%%%%%%%%%%%%%%%%%%%
%       %     %     %G%
%%% % %%%%% % %%% % % %
% % %       %   % %   %
% % % % %%% %%% % %%% %
%     %   %         % %
% %%% % % % % % %%%%% %
% % %   % % %       % %
% % % %%% %%%%% % %%% %
%P  %         % %     %
%%%%%%%%%%%%%%%%%%%%%%%