%%%%%%%%%%%%%%%%%%%%%%%
%       %     %  ...%G%
%%% % %%%%% % %%%.%.%.%
% % %  .....%   %.%...%
% % % %.%%%.%%% %.%%% %
%.....%.  %.......  % %
%.%%%.%.% % % % %%%%% %
%.% %...% % %       % %
%.% % %%% %%%%% % %%% %
%P  %         % %     %
%%%%%%%%%%%%%%%%%%%%%%%