%%%%%%%%%%%%%%%%%%%%%%%
%       %     %     %G%
%%% % %%%%% % %%% % % %
% % %       %   % %   %
% % % % %%% %%% % %%% %
%     %   %         % %
% %%% % % % % % %%%%% %
% % %   % % %      G% %
% % % %%% %%%%% % %%% %
%P  %        G% %     %
%%%%%%%%%%%%%%%%%%%%%%%