%%%%%%%%%%%%%%%%%%%%%%%%%%%%%%%%%%%%%
%% P%%%%%%%%%%%%%%%%%%%%%%%%%%%%%%%%%
%%  %%%%%%%%%%%%%%%%%%%%%%%%%%%%%%%%%
%%  %%%%%%%%%%%%%%%%%%%%%%%%%%%%%%%%%
%%                                  %
%% %%%%%%%%%%%%%%%%%%%%%%%%%%%%%%%% %
%% %%%%%%%%%%%%%%%%%%%%%%%%%%%%%%%% %
%% %%%%%%%%%%%%%%%%%%%%%%%%%%%%%%%% %
%% %%%%%%%%%%%%%%%%%%%%%%%%%        %
%% %%%%%%%%%%%%%%%%%%%%%%%%% %%%%%%%%
%% %%%%%%%%%%%%%%%%%%%%%%%%% %%%%%%%%
%% %%%%%%%%%%%%%%%%%%%%%%%%  %%%%%%%%
%% %%%%%%%%%%%%%%%%%%%%%%%% %%%%%%%%%
%% %%%%%%%%%%%%%%%%%%%%%%%% %%%%%%%%%
%% %%%%%%%%%%%%%%%%%%%%%%%% %%%%%%%%%
%% %%%%%%%%%%%%%%%%%%%%%%%%         %
%% %%%%%%%%%%%%%%%%%%%%%%%%%%%%%%%% %
%% %%%%%%%%%%%%%%%%%%%%%%%%%%%%%%%% %
%% G                                %
%%%%%%%%%%%%%%%%%%%%%%%%%%%%%%%%%%%%%
