%%%%%%%
%P    %
%     %
%    G%
%%%%%%%
