%%%%%%%%%%%%%%%%%%%%%%%%%%%%%%%%%%%%%
%P                                  %
%  %                                %
%  %                                %
%  %                                %
%  %                                %
%  %                                %
%  %                                %
%  %                                %
%  %                                %
%  %                                %
%  %              G                 %
%%%%%%%%%%%%%%%%%%%%%%%%%%%%%%%%%%%%%
